1111111111111111111
1000000000000000001
1000000000000000001
1000000000E0000P001
10000000000000C0001
1000000000000000001
1000000000000000001
1000000000000000001
1000000000000000001
1000000000000000001
1000000000000000001
1111111111111111111